############
#        O #
#       ####
#          #
#######    #
# O ##     #
#   ##  P  #
#          #
#          #
#       #  #
############