############
#          #
#       ####
#          #
#######    #
#   ##     #
#   ##  P  #
#          #
#        X #
#       #  #
############