############
#        O #
#       ####
#          #
#######    #
# O ##     #
#   ##     #
#          #
#       XX #
#       #  #
############