############
#        O #
#   P   ####
#          #
#######    #
# O ##     #
#   ##     #
#          #
#       XX #
#       #  #
############c