############
#        O #
#       ####
#          #
#######    #
#   ##     #
#   ##  P  #
#          #
#       XX #
#       #  #
############